
F 255,100,0


C 255,30,0


WE ./textures/wall.xpm
EA ./textures/wall.xpm
NO ./textures/wall.xpm
SO ./textures/wall.xpm
 
 

   
   
    

        1111111111111111111111111
        1000000000110000000000001
        1011000001110000000000001
        1011000000070000000000001
111111111011000001110000000000001
100000000011000001117111111111111
11110111111111011100000010001
11110111111111011101010010001
11000000110101011100000010001
10000000000000001100000070001
10000000000000001101010010001
11000001110101011111011110N0111
11110111 1110101 101111010001
11111111 1111111 111111111111

  

  
dwa
